Athens	Athens	GR	modern
Sparta	Sparti	GR	modern
Therapnes	Therapnes	GR	modern
Mycenae	Mycenae	GR	ancient
Istanbul	Istanbul	TR	modern
Tiryns	Tiryns	GR	ancient
Iolkos	Iolkos	GR	ancient
Gla	Gla	GR	ancient
Thebes	Thivai	GR	modern
Orchomenos	Orchomenos	GR	modern
Pylos	Pylos	GR	ancient
Argos	Argos	GR	modern
Megara	Megara	GR	modern
Corinth	Korinthos	GR	ancient
Thessaloniki	Thessalonica	P	ancient
Serres	Sirra	P	ancient
Naupactus	Naupactus	P	ancient
Koroni	Koroni	GR	modern
Andravida	Andravida	GR	modern
Edirne	Edirne	TR	modern
Pella	Pella	GR	modern
Philippi	Philippi	GR	ancient
Messene	Messene	P	ancient
