Amantia	Amantia	P	ancient
Constanța	Constanta	RO	modern
Devnya	Devnya	BG	modern
Doclea	Doclea	P	ancient
Dyrrhachium	Durres	AL	modern
Faros	Pharus	P	ancient
Lezhë	Lezhe	AL	modern
Niš	Nis	RS	ancient
Oricum	Oricum	P	ancient
Phoenice	Phoinike 2	P	ancient
Pliska	Pliska	BG	ancient
Plovdiv	Plovdiv	BG	ancient
Preslav	Veliki Preslav	BG	ancient
Ratiaria	Ratiaria	P	ancient
Scupi	Scupi	P	ancient
Silistra	Silistra	BG	modern
Sirmium	Sirmium	P	ancient
Skopje	Skopje	MK	modern
Sofia	Sofia	BG	modern
Split	Split	HR	modern
Stobi	Stobi	P	ancient
Tarnovo	Veliko Turnovo	BG	modern
Varna	Varna	BG	modern
Vidin	Vidin	BG	modern
Viminacium	Viminacium	P	ancient
Vis	Vis	HR	modern
