Almería	Almeria	ES	modern
Antequera	Antequera	ES	modern
Astorga	Astorga	ES	modern
Baelo Claudia	B(a)elo	P	ancient
Barcelona	Barcelona	ES	modern
Cáceres	Caceres	ES	modern
Cádiz	Cadiz	ES	modern
Cartagena	Cartagena	ES	modern
Carteia	Carteia/Calpe/Karpessos	P	ancient
Córdoba	Cordoba	ES	modern
Écija	Ecija	ES	modern
Gibraltar	Gibraltar	GI	modern
Granada	Granada	ES	modern
Jaén	Jaen	ES	modern
Lugo	Lugo	ES	modern
Madrid	Madrid	ES	modern
Málaga	Malaga	ES	modern
Mérida	Merida	ES	modern
Murcia	Murcia	ES	modern
Pamplona	Pamplona	ES	modern
Sagunto	Sagunto	ES	modern
Salamanca	Salamanca	ES	modern
Seville	Sevilla	ES	modern
Tarragona	Tarragona	ES	modern
Toledo	Toledo	ES	modern
Valencia	Valencia	ES	modern
Zaragoza	Zaragoza	ES	modern
