Knossos	Knossos	P	ancient
Phaistos	Phaistos	P	ancient
Heraklion	Irakleion	P	modern
Lyktos	Lyktos	P	ancient
Olous	Olous	P	ancient
Hierapytna	Hierapytna	P	ancient
Praisos	Praisos	P	ancient
Gortyn	Gortyn	P	ancient
Rhithymna	Rhithymna	P	ancient
Lappa	Lappa	P	ancient
Kydonia	Kydonia	P	ancient
Polyrrenia	Polyrrenia	P	ancient
Phalasarna	Phalasarna	P	ancient
Arkades	Arkades	P	ancient
Itanos	Itanos	P	ancient
Malia	Malia	P	ancient
Kato Zakros	Kato Zakros	P	ancient
Galatas	Galatas	P	ancient
Agia Triada	Agia Triada	P	ancient
Gournia	Gournia	P	ancient
Pyrgos	Pyrgos	P	ancient
Vasiliki	Vasiliki	P	ancient
Fournu Korfi	Fournu Korfi	P	ancient
Pseira	Pseira	P	ancient